####################################################################################################
####################################################################################################
####################################################################################################
####################################################################################################
#########################################                                                       #  O
######################################### ################################################## ## # ##
######################################### ################################################## ## # ##
######################################### ################################################## ##   ##
######################################### ##############          ########################## #### ##
######################################### ############## ######## ########################## #### ##
######################################### ############## #     ## ########################## #### ##
######################################### ############## # ### ## ########################## #### ##
################                          ############## # # # ## ########################## #### ##
################ ####################################### #   # ## ########################## #### ##
################ #####################################   ##### ## ########################## #### ##
################ ##################################### ####### ## ########################## #### ##
################ #####################################         ##                            #######
########         ###################################################################################
######## ###########################################################################################
######## ######               ######################################################################
######## ###### ############# ######################################################################
######## ###### #############          #############################################################
I               ############# ######################################################################
###############               ######################################################################
##################### ######################           #############################################
##################### ###################### ######### #############################################
##################### ###################### ######### #############################################
#####################                        ######### #############################################
############################################ ######### #############################################
############################################ ######### #############################################
############################################ ######### #############################################
############################################ ######### #############################################
############################################           #############################################
####################################################################################################
