#############################################
I ##########            #################   #
# ########## ########## ################# # O
#            ##########                   ###
############ ###################### #########
############ ###################### #########
############                   ####        ##
##################################### #######
#####################################      ##
#############################################