###########################################################
############                ###############################
I            ##############################################
############ ##############################################
############                                              O
###########################################################


